...###########################################
.S....#.....#.....#........#...........#..#..#
#..#..#..#..####..####..#..#######..####..#..#
#..#.....#..#...........#..#..#..............#
##########..#..#######..####..##########..#..#
#.....#.....#..#.....#.....#..............#..#
####..####..#..#..####..####..##########..#..#
#.....#.....#..#........#..#..#...........#..#
#..#######..####..#######..#######..#..#..#..#
#.....#.......................#.....#..#..#..#
#..#..#..#######..#..#..#..#..#..#..##########
#..#........#.....#..#..#..#..#..#..#........#
####..#..####..#..#..#######..####..#######..#
#..#..#.....#..#..#.....#.....#..#..#........#
#..#..####..#######..##########..#..#..####..#
#........#..#..#..#........#..#.....#.....#..#
####..#######..#..#..####..#..#..#..#..#..####
#..............#.....#..#..#.....#..#..#.....#
#######..#..#######..#..####..####..#..#######
#........#..#....................#..#........#
####..#######..#######..#######..#..#..#######
#...........#.....#........#..#..#..#........#
#..####..#######..#..#######..#..####..#..####
#..#.....#..#.....#...........#.....#..#..#..#
#######..#..#..#######..####..#..#..####..#..#
#..#..#.....#..#.....#.....#..#..#.....#.....#
#..#..#######..####..####..#..#..#######..####
#...........#..#.....#.....#..#..#..#........#
####..####..####..#..####..#######..####..#..#
#........#........#.......................#.G#
###########################################..#